**********
*        *
* * ******
* **     *
* *  * * *
* *      *
* *** ****
* *      *
**********